11111111111111
100E000P0000C1
10000000000001
10000C11000001
1000CCC1100001
11111111111111