1111111
1000001
1000001
1000P01
1CC00E1
1111111