1111111111111
1101010101101
1000000000CC1
100011E00CCP1
1111111111111
